5 5 
1 1 1 1 1 
1 7 2 2 1
1 1 1 1 1
1 2 2 9 1
1 1 1 1 1
