5 5
1 1 1 1 1 
1 2 2 2 1 
1 2 1 1 1 
0 0 0 2 1 
1 1 1 1 1 
3 20
2
p 173 360 -1 0

0